SO ../images/texture4.xpm
NO ../images/texture3.xpm
WE ../images/texture2.xpm
EA ../images/texture1.xpm


F 255, 255, 255
C 0,0,0

11111111111111111
10000111000000001
101100S0000000001
10010000000000001
11111111100001111
1011011W110011101
1101110011100111
111101110100001
1111111111111111
11111111
10000001
10000001
10000001
11111111