NO ../images/texture1.xpm
SO ../images/texture2.xpm
WE ../images/texture3.xpm
EA ../images/texture4.xpm
F 80, 150, 80
C 102, 153, 255

1111111111111111111111111
1000000000110000000000001
1011000001110000000000001
100100000000000000N000001
1111111110110000011100001
100000000011000001110111111111111
11110111111111011100000010001
11110111111111011101010010001
11000000110101011100000010001
10000000000000001100000010001
10000000000000001101010010001
1100000111010101111101111000111
11111111 1111111 111111111111 11111111 1111111 111111111111
