NO ../images/texture1.xpm
SO ../images/texture2.xpm
WE ../images/texture3.xpm
EA ../images/texture4.xpm
F 80, 150, 80
C 102, 153, 255

11111111111111111
10000000000000001
101100W0011000001
10010000000001111
11111111100001
10110111110011111
11011100111001
11110111010001
1111111111111111
