NO ../images/texture1.xpm
SO ../images/texture2.xpm
WE ../images/texture3.xpm
EA ../images/texture4.xpm
F 80, 150, 80
C 102, 153, 255

111111
100101
1S0001
100101
100011111
100000001
100000111
1111101
1111111
