NO ./images/texture1.xpm
SO ./images/texture2.xpm
WE ./images/texture3.xpm
EA ./images/texture4.xpm
F ,220, 100, 0
C 225,30,0

111111111
100000101
1000E0101
111100101
100010101
100000001
1000001
1111101
1111111 
