NO ../textures/wood.xpm
SO ../textures/barrel.xpm
WE ../textures/mossy.xpm
EA ../textures/redbrick.xpm
F 0,0,0
C 255,255,255

111111111
100000101
1000E0101
111100101
100010101
100000001
100000111
1111101
1111111
